1,1,1,1,1,1,1,1,1,1,1,1,1,1,1,1,1,1,1,1,1,1,1,1,1,1,1,1,1,1,1,1,1,1,1,1,1,1,1,1,1,1,1,1,1,1,1,1,1,1,1,1,1,1,1,1,1,1,1,1,1,1,1,1,1,1
2,2,2,2,2,2,2,2,2,2,2,2,2,2,2,2,2,2,2,2,2,2,2,2,2,2,2,2,2,2,2,2,2,2,2,2,2,2,2,2,2,2,2,2,2,2,2,2,2,2,2,2,2,2,2,2,2,2,2,2,2,2,2,2,2,2
1,1,1,1,3,4,5,5,5,5,5,5,5,5,5,5,5,5,5,5,5,5,5,5,5,5,5,5,5,5,5,5,6,7,5,5,5,5,5,5,5,5,5,5,5,5,5,5,5,5,5,5,5,5,5,5,5,5,5,5,8,9,1,1,1,1
2,2,2,2,10,11,2,2,2,2,2,2,2,2,2,2,2,2,2,2,2,2,2,2,2,2,2,2,2,2,2,2,12,13,2,2,2,2,2,2,2,2,2,2,2,2,2,2,2,2,2,2,2,2,2,2,2,2,2,2,14,15,2,2,2,2
1,1,1,1,16,1,1,1,1,1,1,1,1,1,1,1,1,1,1,1,1,1,1,1,1,1,1,1,1,1,1,1,17,18,1,1,1,1,1,1,1,1,1,1,1,1,1,1,1,1,1,1,1,1,1,1,1,1,1,1,1,19,1,1,1,1
2,2,2,2,20,2,2,2,2,2,2,2,2,2,2,2,2,2,2,2,2,2,2,2,2,2,2,2,2,2,2,2,12,13,2,2,2,2,2,2,2,2,2,2,2,2,2,2,2,2,2,2,2,2,2,2,2,2,2,2,2,21,2,2,2,2
1,1,1,1,16,1,1,1,1,1,1,1,1,1,1,1,1,1,1,1,1,1,1,1,1,1,1,1,1,1,1,1,17,18,1,1,1,1,1,1,1,1,1,1,1,1,1,1,1,1,1,1,1,1,1,1,1,1,1,1,1,19,1,1,1,1
2,2,2,2,20,2,2,2,2,2,2,2,2,2,2,2,2,2,2,2,2,2,2,2,2,2,2,2,2,2,2,2,12,13,2,2,2,2,2,2,2,2,2,2,2,2,2,2,2,2,2,2,2,2,2,2,2,2,2,2,2,21,2,2,2,2
1,1,1,1,16,1,1,1,1,1,1,1,1,1,1,1,1,1,1,1,1,1,1,1,1,1,1,1,1,1,1,1,17,18,1,1,1,1,1,1,1,1,1,1,1,1,1,1,1,1,1,1,1,1,1,1,1,1,1,1,1,19,1,1,1,1
2,2,2,2,22,23,23,23,23,23,24,25,2,2,2,2,2,2,2,2,2,2,2,2,2,2,2,2,2,2,2,2,12,13,2,2,2,2,2,2,2,2,2,2,2,2,2,2,2,2,2,2,2,2,26,27,23,23,23,23,23,28,2,2,2,2
1,1,1,1,16,1,1,1,1,1,29,30,1,1,1,1,1,1,1,1,1,1,1,1,1,1,1,1,1,1,1,1,17,18,1,1,1,1,1,1,1,1,1,1,1,1,1,1,1,1,1,1,1,1,29,30,1,1,1,1,1,19,1,1,1,1
2,2,2,2,20,2,2,2,2,2,26,25,2,2,2,2,2,2,2,2,2,2,2,2,2,2,2,2,2,2,2,2,12,13,2,2,2,2,2,2,2,2,2,2,2,2,2,2,2,2,2,2,2,2,26,25,2,2,2,2,2,21,2,2,2,2
1,1,1,1,3,5,5,31,1,1,29,30,1,1,1,1,1,1,1,1,1,1,1,1,1,1,1,1,1,1,1,1,17,18,1,1,1,1,1,1,1,1,1,1,1,1,1,1,1,1,1,1,1,1,29,30,1,1,32,5,5,9,1,1,1,1
2,2,2,2,20,2,2,33,2,2,26,34,35,2,2,2,2,2,2,2,2,2,2,2,2,2,2,2,2,2,2,36,37,38,39,2,2,2,2,2,2,2,2,2,2,2,2,2,2,2,2,2,2,40,41,25,2,2,42,2,2,21,2,2,2,2
1,1,1,1,16,1,1,43,1,1,29,30,44,45,1,1,1,1,1,1,1,1,1,1,1,1,1,1,1,1,46,47,17,18,48,49,1,1,1,1,1,1,1,1,1,1,1,1,1,1,1,1,50,51,29,30,1,1,52,1,1,19,1,1,1,1
2,2,2,2,20,2,2,33,2,2,26,25,53,54,2,2,2,2,2,2,2,2,2,2,2,2,2,2,2,2,55,56,12,13,57,58,2,2,2,2,2,2,2,2,2,2,2,2,2,2,2,2,59,60,26,25,2,2,42,2,2,21,2,2,2,2
1,1,1,1,16,1,1,43,1,1,29,30,61,62,1,1,1,1,1,1,1,1,1,1,1,1,1,1,1,1,63,64,17,18,65,66,1,1,1,1,1,1,1,1,1,1,1,1,1,1,1,1,67,68,29,30,1,1,52,1,1,19,1,1,1,1
2,2,2,2,20,2,2,33,2,2,26,69,70,2,2,2,2,2,2,2,2,2,2,2,2,2,2,2,2,2,2,71,72,73,74,2,2,2,2,2,2,2,2,2,2,2,2,2,2,2,2,2,2,75,76,25,2,2,42,2,2,21,2,2,2,2
1,1,1,1,77,78,78,79,1,1,29,30,1,1,1,1,1,1,1,1,1,1,1,1,1,1,1,1,1,1,1,1,17,18,1,1,1,1,1,1,1,1,1,1,1,1,1,1,1,1,1,1,1,1,29,30,1,1,80,78,78,81,1,1,1,1
2,2,2,2,20,2,2,2,2,2,26,25,2,2,2,2,2,2,2,2,2,2,2,2,2,2,2,2,2,2,2,2,12,13,2,2,2,2,2,2,2,2,2,2,2,2,2,2,2,2,2,2,2,2,26,25,2,2,2,2,2,21,2,2,2,2
1,1,1,1,16,1,1,1,1,1,29,30,1,1,1,1,1,1,1,1,1,1,1,1,1,1,1,1,1,1,1,1,17,18,1,1,1,1,1,1,1,1,1,1,1,1,1,1,1,1,1,1,1,1,29,30,1,1,1,1,1,19,1,1,1,1
2,2,2,2,82,83,83,83,83,83,84,25,2,2,2,2,2,2,2,2,2,2,2,2,2,2,2,2,2,2,2,2,12,13,2,2,2,2,2,2,2,2,2,2,2,2,2,2,2,2,2,2,2,2,26,85,83,83,83,83,83,86,2,2,2,2
1,1,1,1,16,1,1,1,1,1,1,1,1,1,1,1,1,1,1,1,1,1,1,1,1,1,1,1,1,1,1,1,17,18,1,1,1,1,1,1,1,1,1,1,1,1,1,1,1,1,1,1,1,1,1,1,1,1,1,1,1,19,1,1,1,1
2,2,2,2,20,2,2,2,2,2,2,2,2,2,2,2,2,2,2,2,2,2,2,2,2,2,2,2,2,2,2,2,12,13,2,2,2,2,2,2,2,2,2,2,2,2,2,2,2,2,2,2,2,2,2,2,2,2,2,2,2,21,2,2,2,2
1,1,1,1,16,1,1,1,1,1,1,1,1,1,1,1,1,1,1,1,1,1,1,1,1,1,1,1,1,1,1,1,17,18,1,1,1,1,1,1,1,1,1,1,1,1,1,1,1,1,1,1,1,1,1,1,1,1,1,1,1,19,1,1,1,1
2,2,2,2,20,2,2,2,2,2,2,2,2,2,2,2,2,2,2,2,2,2,2,2,2,2,2,2,2,2,2,2,12,13,2,2,2,2,2,2,2,2,2,2,2,2,2,2,2,2,2,2,2,2,2,2,2,2,2,2,2,21,2,2,2,2
1,1,1,1,16,1,1,1,1,1,1,1,1,1,1,1,1,1,1,1,1,1,1,1,1,1,1,1,1,1,1,1,17,18,1,1,1,1,1,1,1,1,1,1,1,1,1,1,1,1,1,1,1,1,1,1,1,1,1,1,1,19,1,1,1,1
2,2,2,2,87,88,2,2,2,2,2,2,2,2,2,2,2,2,2,2,2,2,2,2,2,2,2,2,2,2,2,2,12,13,2,2,2,2,2,2,2,2,2,2,2,2,2,2,2,2,2,2,2,2,2,2,2,2,2,2,89,90,2,2,2,2
1,1,1,1,77,91,78,78,78,78,78,78,78,78,78,78,78,78,78,78,78,78,78,78,78,78,78,78,78,78,78,78,92,93,78,78,78,78,78,78,78,78,78,78,78,78,78,78,78,78,78,78,78,78,78,78,78,78,78,78,94,81,1,1,1,1
2,2,2,2,2,2,2,2,2,2,2,2,2,2,2,2,2,2,2,2,2,2,2,2,2,2,2,2,2,2,2,2,2,2,2,2,2,2,2,2,2,2,2,2,2,2,2,2,2,2,2,2,2,2,2,2,2,2,2,2,2,2,2,2,2,2